How do I read and find my YouTube comments	How can I see all my Youtube comments
What can make Physics easy to learn	How can you make physics easy to learn
What was your first sexual experience like	What was your first sexual experience
What would a Trump presidency mean for current international masters students on an F1 visa	How will a Trump presidency affect the students presently in US or planning to study in US
What does manipulation mean	What does manipulation means
Why are so many Quora users posting questions that are readily answered on Google	Why do people ask Quora questions which can be answered easily by Google
Why do rockets look white	Why are rockets and boosters painted white
How should I prepare for CA final law	How one should know that heshe completely prepare for CA final exam
What are some special cares for someone with a nose that gets stuffy during the night	How can I keep my nose from getting stuffy at night
What Game of Thrones villain would be the most likely to give you mercy	What Game of Thrones villain would you most like to be at the mercy of
How do we prepare for UPSC	How do I prepare for civil service
What are some examples of products that can be make from crude oil	What are some of the products made from crude oil
How do I make friends	How to make friends 
Is Career Launcher good for RBI Grade B preparation	How is career launcher online program for RBI Grade B
Will a Blu Ray play on a regular DVD player If so how	How can you play a Blu Ray DVD on a regular DVD player
What is the bestmost memorable thing youve ever eaten and why	What is the most delicious dish youve ever eaten and why
How is the new Harry Potter book Harry Potter and the Cursed Child	How bad is the new book by JK Rowling
What is Java programming How To Learn Java Programming Language 	How do I learn a computer language like java
What is the best book ever made	What is the most important book you have ever read
Can we ever store energy produced in lightning	Is it possible to store the energy of lightning
What is a narcissistic personality disorder	What is narcissistic personality disorder
How I can speak English fluently	How can I learn to speak English fluently
How helpful is QuickBooks auto data recovery support phone number to recover your corrupted data files	What is the quickbooks customer support phone number USA
Who is the richest gambler of all time and how can I reach his level	Who is the richest gambler of all time and how can I reach his level as a gambler
What is purpose of life	Whats the purpose of life What is life actually about
What are some of the high salary income jobs in the field of biotechnology	What are some high paying jobs for a fresher with an MTech in biotechnology
How can I increase my height after 21 also	Can height increase after 25
Which is the best gaming laptop under 60k INR	Which is the best gaming laptop under Rs 60000
What are some of the best romantic movies in English	What is the best romantic movie you have ever seen
What causes a nightmare	What causes nightmares that seem real
How does 3D printing work	How do 3D printing work
Will there really be any war between India and Pakistan over the Uri attack What will be its effects	Will there be a nuclear war between India and Pakistan
Can I recover my email if I forgot the password	What should I do if I forgot my email password
Whats the difference between love and pity	What is the difference between love and pity
What do you think China food	How do you think of Chinese food
Why my question was marked as needing imrovement	How can I ask a question without getting marked as need to improve
What mineral holds the highest electrical charge	What mineral can hold the greatest electrical charge
Why does China block sanctions at the UN against the JaisheMohammad JeM chief Masood Azhar	Why does China support Masood Azhar
Can excessive amounts of Vitamin C cause me to have a miscarriage	How can Vitamin C cause a miscarriage
Who are the Rohingya Muslims	Who are the Rohingya people
Does it matter whether humans are selfish or evil	Does it matter whether humanity is evil or not
Does a black hole have mass	Does a black hole have a finite mass
Is Morgan Freeman correct when he says the only way to stop racism is to stop talking about it	What are your views about this Morgan Freeman quote about Racism
Why does Red keep the keys in OITNB	Why does Red keep the keys in season 4 of Orange is the New Black
If I do not monetize YouTube videos  upload copyright content then are there chances that Google may block my account	How do you upload movies on YouTube and monetize them Is there any issue of copyright
What does the Quora website look like to members of Quora moderation	How does Quora look to a moderator
Why nobody answer my questions in Quora	Why is no one answering my questions in Quora
What is the funniest joke you know	What is the funniest joke of all time
How do I use Twitter as a business source	How can I use Twitter for business
Which is the best earphone with deep bass under 1000	Which is the Best earphones under Rs 1000
Which are the best engineering fields	What is the best field of engineering
Does anyone see the relation between Greek gods and Hindu gods	What parallelism can we draw between gods of Hindu mythology Greek mythology Egyptian mythology etc
Which is the best fixed income fund	What is the best fixed income fund
What is it like to live in Cologne	What is it like to live in Kln Germany 
Why does some people prefer small families	Why do some people prefer to live with small family
Do animals kiss	Do animals besides humans kiss
How do you get deleted Instagram chats	How can I view deleted Instagram dms
What if I hired two private eyes and ordered them to follow each other	Would I be able to hire two private investigators and then get them to follow each other
Is it possible to pursue many different things in life	How do I refuse to chose between different things to do in my life
Did Ben Affleck shine more than Christian Bale as Batman	No fanboys please but who was the true batman Christian Bale or Ben Affleck
Which business is good start up in Hyderabad	Which business is better to start in Hyderabad
How can I stop being so possessive	How do I stop being over possessive for a person whom I love
What is the best combination of courses I can take up along with CA to enhance my career	What courses must be taken along with CA course
How do you take a screenshot on a Mac laptop	How do I take a screenshot on my MacBook Pro What are some instructions
What are some must watch TV shows before you die	Are there any must watch TV shows
How can I become more fluent in Chinese	How can I become fluent in chinese
What are the effects of demonitization of 500 and 1000 rupees notes on real estate sector	What will be the impact of scrapping of 500 and 1000 rupee notes on the real estate market
What is the easiest way to become a billionaire	What is the best way to become a billionaire
Why do people hate Hillary Clinton	What are the reasons that people dislike Hillary Clinton
Why is creativity important	Why creativity is important
If Hillary Clinton could not continue her Presidential campaign how would the Democratic Party choose a new candidate	If Hillary Clinton can no longer serve as the Democratic nominee how would her successor be chosen
Is the neutron star made up of	Is the neutron star made up of only neutrons
I got a 38 GPA Is it enough to get into top universities like Harvard	Is a 38 GPA sufficient to get into a top school
How can I learn computer security	How can I get started to learn information security
How do I earn from Quora	Can I earn money on Quora
What is my puk code	Whats the PUK for TF64SIMC4
Will there be another billion dollar lottery Jackpot	When will the lottery reach the next billion dollar jackpot
How do I create a new shell in a new terminal using C programming Linux terminal	How do I create a new Terminal and new shell in Linux using C programming
How can we make the world a better place to live in for the future generations	What can I do to make the world a better place
Why are we worried about others opinions	Why do we care for others opinion and about what others think about us
How do you potty train a 4 months Pitbull	How do I potty train my twomonthold Labrador pup
Which online test series is best for GATE 2017 in CS stream	Which test series is the best for GATE computer science stream
In the play A Raisin in the Sun why do Walter ad Beneatha argue	In A Raisin in the Sun why do Walter and Beneatha argue
What are the signs of an ultra smart person playing dumb	What are signs of ultra smart people hiding their intelligence
Who is disrupting Bloomberg	Who will disrupt Bloomberg
How will the implementation of GST bill impact the lives of common people	What exactly is GST bill and how exactly will it affect the common people
How can you recover your Gmail password	I do not remember my password to my Gmail account how can I recover my account
How accurately can a mental illness can be diagnosed	How can I accurately diagnose and medicate my mental illness
What are the qualities of a good leader	What are some good qualities of a leader
Will Modi win in 2019	Can Narendra Modi become Prime Minister of India in 2019
What exactly is the Common Core InitiativeStandards and what are the pros and cons	What are the pros and cons of the Common Core Standards Initiative
How do I choose a journal to publish my paper	Where do I publish my paper
What are your New Years resolutions for 2017	What is your creative New Years resolution for 2017
How many months does it take to gain knowledge in developing Android apps from scratch	How much time does it take to learn Android app development from scratch
What are the rights of a prisoner	If I am in prison what rights would I have
How can I get free gems in Clash of Clans	How can I get free gems Clash of Clans
What is the best way to get traffic on your website	How do i get traffic for website
How do you feel when someone upvotes your answer on Quora	How does it feel to see upvotes to your answer on Quora
What are some of the best films and TV shows that feature strong female protagonists	What are the best female strong characters in films
How long does it take for a dead body to float to the surface after drowning 	When a dead body is in a river how long does it take before it floats
How can I make money online with free of cost	How do I to make money online
Where can I buy best quality customized cupcakes in Gold Coast	Where can I find delicious cupcakes at Gold Coast
How successful was odd even plan	How successful was the Delhis Oddeven plan
If there will be a war between India and Pakistan who will win	Who will win if a war starts between India and Pakistan
How do you deal with a fear of dying	How can you reduce your fear of dying
Is there an end to the universe and if not is the universe infinite	Is the Universe infinite or is there an end to the Universe
How much funds should I raise	How much money should I raise
What will be the effect of banning 500 and 1000 notes on stock markets in India	What will be the effect of the ban of the 1000rs and 500rs notes on the stock market
How does concentric contractions differ from eccentric contractions	How do concentric and eccentric contraction compare and contrast
What the meaning of this all life	Whats are the meaning of life
Which are the best Hollywood thriller movies	What are the best thriller movie in Hollywood
What job possibilities exist for a Bachelors in Homeland Security	What jobs are available with a bachelors degree in Homeland Security
Which are the best books to understand calculus	What are good books to self study calculus
Why and how did you break up with herhim	How and why did you break up with your ex
What do countries do to prevent war	How should countries prevent war
How can I become a billionaire	How can I become a billionaire in finance
How will Indian GDP be affected from banning 500 and 1000 rupees notes	What will be the implications of banning 500 and 1000 rupees currency notes on Indian economy
Why does understanding death philosophical	What makes understanding death philosophical
Why are dogs considered omnivores	Are dogs carnivorous animals
What are the most interesting foods you have eaten in any country	What is the most delicious dish youve ever eaten and why
How can one increase concentration	How can I improve my concentration
What are the pros and cons of the German Shepherd dog	What are the pros and cons of having a pet German Shepherd
What would be the best way to quit smoking	How did you quitstop smoking
Earthquake resistant homes	How do earthquake resistant buildings work
What is the best phone to buy below 15k	Which are best mobile phones to buy under 15000
How do we start a business	How do I start business from nothing
Whats the best neardeath experience youve ever had	Has anyone ever had a neardeath experience
Why do I keep getting fleas from my dogs	How can I keep my dog from getting fleas
What year did the letter J come	When was the Letter J created
What are the most important books ever written	What is the most important book you have ever read
How can I become a good speaker	What should I do to be a good Speaker
How can I write a letter to Mr Narendra Modi	How can I write to Narendra Modi
What do you think about the Bermuda Triangle	What are your theories about Bermuda Triangle
What should someone do to overcome anxiety	What should I do to avoid depression and anxiety
How do I maintain my peace of mind	How can I maintain my peace of mind
Which one is better among KMC Manipal and KMC Mangalore	What is the brief comparison of KMC in Manipal and Mangalore
How do I keep motivation to learn a language	How do you keep motivated when you learn a new language
What is the different between Chinese wedding ceremony and western wedding ceremony	What is the difference between Chinese and Western style wedding
Why should one hate Shahrukh Khan	Why do people hate Shahrukh Khan and why do people feel that he is not an Indian
What are the best selfhelp books youve ever read	What are the top self help books I should read
Is Evernote useful	What is Evernote used for
What is a good song to lyric prank your best friend	What are some good lyric prank songs to send your best friends
How do I pass a drug test for methamphetamine	Can hair dye help pass a hair follicle drug test for daily meth smokers
How could start with open source development	How should I start contributing to open source projects
Do cricket players really drink tea on a tea break	Do cricketers actually drink tea during tea break
How can I get entry in MIT	What are the requirements for selection into MIT
Does a fetus breathe when its inside a womb	How does a fetus exhale in the womb
What are movies with incest scenes	Are there any good incest movie
Do you regret your divorce	Have you ever regretted your divorce
Is Donald Trump taking cocaine as Howard Dean suggests	Are there any strong indications that Donald Trump does cocaine
How can I see the Comedy Nights with Kapil live show	What is the way to watch Comedy Nights with Kapil live on the sets
Whats your bucket list	What is your bucket list
How did you first come across porn	How were you first introduced to porn
What can I eat every day to be more healthy	Is it healthy to eat a whole avocado every day
What would Hillary Clinton do now that the election is over	What will Hillary Clinton do now
Should I use Vicks Vapor Rub for a stuffy nose	How do you apply Vicks Vapor rub to treat a stuffy nose
How I start prepare for UGC net English literature latest syllabus	How do I prepare for Net JRF in English literature
What are your views on Modi governments decision to demonetize 500 and 1000 rupee notes How will this affect economy	What are your views on ban of 500 and 1000 rupee notes in India
Why is Saltwater Taffy candy imported in Greece	Why is Saltwater taffy candy imported in China
What are the minimum requirements to enter MIT	How can I join MIT
Israel vs Iran who would win	If Israel and Iran went to war who would win
When is it too late to learn the piano	Im almost 40 Is it too late for me to learn piano
How we can travel faster than light	Is it possible to travel faster than light
What is it like being a firefighter	Whats it like to be a firefighter
What are the life lessons that Batman teaches us	What are the life lessons you can learn from the dark knight
How do you stop a criminals attempt to kidnap you so you escape unharmed	How do you stop a criminals attempt to kidnap you and escape unharmed
How do I sell on Amazon	How do I start selling on Amazon
Daniel Ek When an we expect Spotify in India	Daniel Ek Are there any future plans of releasing Spotify in India
What are the top 10 books one should read in his or her early 20s	What books are worth reading in early 20s
Which book should I start with for the GATE preparation	What book do I start with for GATE preparation
What is similar to 4Shared	What is similar to 4shared but better
What are some good places to learn mountaineering in India	What are some good mountaineering institutes for a beginner level mountaineering course
Can climate change be reversed	Can the global climate change be reversed or halted
Did Mahabharata really happen	Did Mahabharata really happen or only an allegory according to MKGandhi
Why are police lights red and blue	Why are police lights red andor blue
How do I post a question that was marked as needing improvement	Why was my question marked as needs improvement
How do I prepare for software interviews	What are the best ways to prepare for software interviews
Does Rahul Gandhi have any chance to become next PM of India after Modi	Does Rahul Gandhi have chances to become next Pm of India after Modi
What is the difference between a comet and an asteroid	What is the difference between asteroids and comets
How should I study	What are some tricks to study effectively
What makes a programmer good	What makes a good programmer great
Is civil war likely after the US presidential election	Is the US at risk of some type of uprising after the election
Where and how do the crop circles get generated	What are crop circles
Will baking soda help pass a urine test	How does baking soda help you pass a drug test
What is Zika virus and how is it transmitted	How is Zika virus spread
What is the best way to learn algebra by yourself	How do you learn algebra 1 fast
What is the best place for sex	What is the best place to have sex from
How do you feel about the new MacBook Pro late 2016	Should I get the new Macbook Pro
What are the major differences between Chinese culture and western cultures	What is the difference between Chinese and western culture
What are scraping techniques	What are some good free web scrapers  scraping techniques
Is it healthy to eat egg whites every day	Is it healthy to eat one chicken every day
What are the best places to recommend foreigners to visit in Nepal	What are the best places to visit in Nepal
How imminent is world war III	Are we heading toward World War 3
How do you write a song	How do I write a song
What could be Narendra Modis next move after demonetization	What is next step after demonetization
If you have me you want to share me If you share me you havent got me What am I	If you have me you want to share me If you share me you dont get me What am I
What is an interesting fact that you know and I dont but shouldnt	What is the most interesting fact that most people dont know about
Where do I find 3ds emulator for android	Is there a working Nintendo 3DS emulator for PC
How can I become a true computer science engineer	How do I become a good computer science engineer
What can you do in lucid dreams	How was your experience of Lucid dreaming
How can I hack someones whatsapp account	How can I hack another WhatsApp account
What is the best lesson in life	What is the most important lesson you have learned from life
How will Trumps presidency affect Indian students who are planning to do a PhD in the US	How would Trump presidency affect Indian students in the US
What are the best daily life hacks one can use to make his life easy	What are the hacks in daily life
What is your favourite anime character and why	What is your favorite anime character And why
How many Mechanical Engineers graduate from India per year	How many mechanical engineers graduate per year in India
How do I start a successful private equity firm	What do you need to start your own private equity firm
What can be the medium budget to visit best places in Kerala for three members 23 days	What are the best places to visit in Kerala for college students
How can I earn money from YouTube	How do I make money through YouTube
How can I start civil service exam preparation from scratch	When should I start preparing for the civil service exam
What is the difference in pleasure between masturbation and sex	What is the difference between sex and masturbation when it comes to pleasure
Do you have any psychic abilities	Do you have psychic power
What is your take on Urjit Patel as the new RBI governor	Is Urjit Patel is right person for RBI Governor
Do Trump voters care that he has reneged all his campaign promises	How will Trump supporters react once they realize he cant or wont keep his campaign promises
Can I learn while sleeping If so how	How can I efficiently learn while sleeping
How do I stop being addicted to porn	How can I stop watching porn
What is the meaning of life Whats our purpose on Earth	What do you feel is the purpose of life
How is time travel possible	Do you think time travel is possible
How can one get a fuller face	How do I do to get fuller face
Is it too late for me at the age of 25 thinking to start a career in photography	I want to start my career as a photographer at age of 25 Is it too late
Whats the best time to have sex	When will the best time for having sex
Can we create free energy	How do we make free energy
Whats the funniest highbrow joke youve ever heard	What are the funniest jokes  stories you ever heard
What are some movies that everyone needs to watch at least once in life	What movies would you recommend everyone to watch
Can World War 3 ever take place	Is World War 3 more imminent than expected
How can eating prunes help during a constipation	Does eating prunes help with constipation
Why is Barack Obama so important for the world	Why is Barack Obama so important to the world
What is the reason Pakistan supports terrorism	Has Pakistan become a safe haven for global terrorism
How do I can stop hairfall	How can I stop hairfall
In your opinion what is the best classical song of all time	Whats the best classical music piece of all time
Is there any other website similar to Quora	Are there any website like Quora
What are the conditions in European refugee camps	How are the conditions inside European Refugee Camps
How do I develop my presence of mind	How can I increase my presence of mind
What are the good websites to learn C programming for begineer	How can we learn c programming
Will the Supreme Courts decision of playing the National Anthem before movie screenings affect your patriotism	What are your views on the supreme courts decision to make playing national anthem mandatory in cinema halls
Why do people hate twilight saga	Why do people hate Twilight so much
How can I improve my spoken English ability	How can I improve my English speaking 
How do I make money with YouTube	How do I make money through YouTube
How do I find love in life	How do I find the love of my life
Is there any way to get rid of gynecomastia	How can I get rid of man boobs
Are there any scientific reasons behind Hindu temples	What is the scientific reason behind visiting temples
Where can I get super high quality photos for any photo booth services in Sydney	Where can I get professional photo booths service in Sydney
How can I control on my anger	How can someone control their anger
How do I get off Quora	How do get out of Quora
What are the best available smartphones gadgets	What are some of the best smartphones technology gadgets
How does it feel to be a closeted gay in India	How does it feel to be homosexual in India
What happens if dictatorship is continuing in the present days	What happens if a dictatorship continues in the present day
What makes a great cup of coffee great	What makes a perfect cup of coffee
Is the US election rigged	Was the US election rigged
Whats your opinion about the decision on removal of 500 and 1000 rupees currency notes	What is the use of demonetizing Rs 500  Rs 1000 notes
What are some of the most mindblowing facts about Bengaluru	What are some interesting facts about Bengaluru
Which book is best for Neet chemistry	Which is the best book for chemistry for NEET
Why are so many questions posted to Quora that are so easily answered by using Google	Why do many Quora users ask questions they could look up online
Which are the best movies of 2016	What is your best 2016 movie
What would be effect of 500 and 1000 Rs notes ban	Why Central Govt banned old 500 and 1000 Rs note but issued new 500 and 2000 Rs note
How light bend with gravity	If gravity bends light can light bend gravity
How do you send a private message to someone youre following on Quora	How do I send another person a message on Quora
How do you train a white Pitbull with brown spots	How do I train White Pitbulls
What are some of the most surreal questions asked on Quora	What is the most surreal question on Quora
When will the best time for having sex	What would be the best time to have sex
How can I consult a good free online astrologer	Are there any good free online astrologers
Why do brothers hate sisters	Why do we hate our sisters
Is Textile Engineering Good	Is textile engineering good or not
How does Quora quickly mark questions as needing improvement	Why does Quora mark my questions as needing improvementclarification before I have time to give it details Literally within seconds
How will I contact a good hacker	How can I hire a hacker
What is the meaning and purpose to life	What is the exact meaning of life
What should I do when my friends betray me	What can I do when my friend betrayed me
Why is Saltwater taffy candy imported in China	Why is Saltwater taffy candy imported in Laos
Who are the best hackers in India	Who is best Indian hacker
Should the Indian education system be changed	Do we need to change the  education system of India If yes then why
Is it too late to go to medical school and become a doctor	Is it too late to go to medical school at 24
What government exams other than the GATE can final year computer science students give	What government exams other than the GATE can average mark final year computer science students give
Psychopaths Do you find babies cute	Do psychopaths find babies cute
How can I see who blocked me at Facebook	Will I see if someone blocked me of Facebook
Who are some of great coders from Tamil Nadu	Are there any competitive coders from Tamil Nadu
What is the ultimate way to serve humanity	How can one serve humanity
What will be the resolution one should have for the year 2016	Whats your resolution for year 2016
What are Balaji Viswanathans views on caste based reservations in India	What is Balaji Vishwanathans view on caste based reservation system in India
What are Mutual funds How do they work	What is mutual fund all about
What is the main difference between socialism and communism	What is the difference between socialism marxism and communism
How do I change my Facebook password	How can I log in Facebook without password
Which one to learn C or C	Which should I learn first C or C
What is the best evidence for a historical Jesus	What is the evidence for and against the existence of the historical Jesus
What are some of the best parttime jobs where you can work from home and make some good cash	What are some of the best paid part time jobs that can be done from home
Does Trump have a chance at winning presidency	Is there a big chance that Trump will win the election
How can I meet Suresh Raina	How do i meet suresh raina
Can fossil records be used as evidence for evolution If so how	What are some examples of evidence of evolution that fossil records provide
What is the Hizmet movement	What is the Glen movement
What stocks are the best to invest in right now	What are the best stocks to invest for long term right now
What should I do if someone has posted a porn video under my name	What should I do if someone has posted porn video under my name
What are the safety precautions on handling shotguns proposed by the NRA in Alaska	What are the safety precautions on handling shotguns proposed by the NRA in Arizona
How do I get my ex back	How do I ask my ex to get back together
What is the best way to prepare to IELTS	What is the best way to prepare for IELTS
How do I know if the girl am dating online truly live me for real	How do I know if my online girlfriend truly loves me
What is a GDP	What is the significance of GDP
What are the home remedies for piles or anal fissure	How do I cure anal fissure permanently with home remedies
Is the soul immortal	Why is the soul immortal
What can be done to reduce the pollution of India	What is the best way to reduce pollution in india
Which were some of the bad experiences you had in life	What were some of your good and bad life experiences
Can you get a list of individual telephone numbers	How do you get cell phone numbers
Do you have to wake up during REM sleep to remember your dreams	Do you need to wake up in the middle of REM sleep in order to remember you dreams
How do I learn how to sing	I want to learn singing How do I start
Which is the best SSC and banking training insititute in Chandigarh	Which institute provide best SSC and banking coaching in Chandigarh
Which is the best PMP Certification course provider in Bangalore	Which is the best pmp certification center in Bangalore
What is difference between net and gross income	What is the difference between gross income versus net income
How can I wake up early in the morning	How can I get up early in the morning
What is the difference between the iPhone 6s and iPhone 6s Plus	Whats the difference between the iPhone 6 and the iPhone 6s
What is the IELTS all about	What is IELTS and its use
How do I lose weight without doing any sport	How do I lose weight without doing exercise or diet
Why do digital cameras have shutter sound	What digital cameras have electronic shutter that can be set to make absolutely no sound or noise
What were the main and most important political causes of World War 1	What were the causes for World War 1
What is the difference between HDD and SSD in laymans terms	What is differences between SSD and hdd
What does it mean if a dog vomits white foam	Why is my puppy vomiting white foam
How is the job situation in New Zealand for computer science graduates	How is the job situation in New Zealand for computer science graduates diploma
How would I develop an ecommerce website	How do I create an ecommerce website
What can I do to improve my question on Quora	All my questions on Quora need improvement What is the best way to ask a question on Quora
What are some tips for someone trying to teach themselves to sing	How can I teach myself how to sing
What are some of the pros and cons of a Hillary Clinton presidency	What are pros and cons of Hillary Clinton
Which is the best coaching center for SSC and Banking in Chandigarh	Which are the best SSC and banking coaching centers in Chandigarh
What are the best things to do on Halloween	What do we need to have the best Halloween
Why do companies issue bonus shares	Why do company issue bonus shares
How can changing 500 and 1000 rupee notes end the black money in India	Do you think scrapping of 500 and 1000 rupee denominations is going to eradicate corruption
Have you ever been fired	Have you ever been fired How did you deal with it
How on earth would I dress like a workout guy from the year 1990 in the summer	How would I dress like a workout guru from the year 1990 in the summer
My girlfriend has stopped talking to me What should I do	My girlfriend is not talking to me What should I do
What will the real estate look like now after the 500 and 1000 scraping	How will abolishing Rs 500 and Rs 1000 notes affect the real estate businesses in India
What are the best interview questions ever asked	What are the best interview questions to ask
Has wizard magic been scientifically tested	Have mages been scientifically tested
Why there is so much nudity content in Game of Thrones	Why is there so much nudity in the Game of Thrones TV Series
How can I get followers and comments on my blog	How can i get more follower on my blog
I have only 2 months for my CA CPT exams how do I prepare	I want to crack CA CPT in 2 months How should I study
What programming language should I learn if I want to do a 2D MMORPG game	Which programming language should I learn if I want to develop gaming apps
What is your view on the recent demonetization in India	What are your views on demonetization of 500  1000 notes in India
Why was cyrus mistry removed	Why TATA sons replaced Cyrus Mistry to Ratan TATA
What is the first moment you remember in your Life	What is the very first thing you remember in your life
What can I do after completing BDS	What can we do after completing BDs
Does all Muslims hate Narendra Modi	Why Muslims hate Modi government
Im 18 What should I do	What can I do when Im 18
What are some really good and famous romantic comedy movies	What are the best romantic comedy movies
How should I start meditating	How should I start meditating and when
Can an infinite amount of dark or vacuum or gravitational energy be created with expansion	Is the potential energy of vacuum energy virtual particles andor dark energy infinite NO MERGE
Should you post picture on social media	Should you post pictures on social media
Can we control our actions in a dream	Can we control our dreams Can we dream what we wanna dream about
Did Trump win the election	Does Donald Trump have any chance of winning the forthcoming election
Why does the caste system still exist in India	Why does the caste system exist in India even after 7 decades of Independence
How do I get a boyfriend for age 13	How can I get a boyfriend at age 13
What are some new marketing techniques for language schools	What are marketing techniques for language schools
What are the easy ways to earn money online	How can I earn money on internet
What is reactance in a capacitor	What is the reason behind the reactance of a capacitor
Why is Saltwater taffy candy imported in Australia	Why is saltwater taffy candy imported in Austria
Which are the best parttime jobs to do in Bangalore	What are the best part time jobs we can do in Bangalore
How do I become an attractive girl	How do you become prettyattractive
What are some of the best music albums ever	What is regarded as the best music album
Realistically speaking what would happen to the USA if Donald Trump wins Presidency in the 2016 elections	Why is Donald Trump supported so much What will happen if he wins the election
Whats it like to be a nonsmoking mother of smoking children	Whats it like to be nonsmoking mother of the smoking children
How comfortably can I live in Washington DC on a 80000 salary	Can I live comfortably in DC on 80000  114000 salary
How do you find out if a girl has a boyfriend	How do I tell if a girl has a boyfriend
How could I gain weight in a healthy way	How can I gain healthy weight and mass
How do I know if my spouse is my soulmate	How can I know that he is my soulmate
How do I get to be a people person	How should I be a people person
How does a long distance relationship work	Do long distance relationships work
HOw do I speak Fluent English	How can I understand english
Where can I find a hacker for good cause	Where can I find a good hacker
What can I do to get a job at Microsoft	How do I get job in Google or Microsoft
Is it physically possible to travel back in time	Is it possible to travel back or forward in time
How do I recover deleted messages in Facebook	How do I recover deleted Facebook messages
Life can be boring What to do	My life is boring What can I do
What would be a cool way to commit suicide	What can be the most insane ways to commit suicide
What is the best age to teach a child how to swim	When is a good time to teach your children how to swim
Which is less healthy for your body beer or Pepsi	Which is less healthy for your body light beer or Pepsi
What would cause an AMP to cut out	What would cause an AMP to cut out How do you fix it
How do I score good marks in mathematics	How do I score good marks in mathematics 9 cbse
Why does Facebook Messenger use long polling over WebSockets	Does Facebook messenger use long polling or websockets
What are the chances of ww3	Is there any possibility of a WW3
What are the application of binary search trees	What are the applications of binary search trees
Do you think of mathematics as art or science	Is math an art or a science
Is scientology a fraud	Is Scientology bullshit
Who will win the 2016 presidential election	Who will win the 2016 US presidential election and why
How does specific heat and heat capacity differ	Is heat capacity the same as specific heat
What are some interesting things to do when bored	What should I do if Im badly bored
Movie Review What is your review of Aamir Khans Dangal 2016 movie	What is your honest review of Dangal 2016 movie
What do you think about the movie Interstellar	What do you think about the movie Interstellar
Are most blind people completely blind	Are most blind people fully blind
How does someone knows they have social anxiety	How do I know if I have social anxiety
Is evolution real How has this been proven	What are the different ways in which evolution has been proven to be real
Is the US Constitution considered to be a living document If so why	What makes the US Constitution a living document
What makes you believe that Everything happens for a good reason	Do you believe that everything happens for a reason
What are the best things to learn in life	What is the best thing we learned from our life
Can a sociopath have many psychopathic traits	Can you be a sociopath with more psychopathic traits
How could Quora attract initial users	When did Quora start and how did it attract users
What is the shopping mall of the future	What will shopping malls be like in the future
What is white hat SEO	What is whitehat SEO
What is the average salary of a physician in india	What is the salary of a doctor in India
Where can I get free books to read or download	Where can I get free books
What makes India different from the rest of the world	What makes India different from all other countries in the world
As a freshman how do you promote an app for free	How do you promote your app for free
Why does Dubai Police drive fast car	Why do the Dubai Police have super cars
Can you dream while awake	Can people dream while they are awake
Can I do meditation all day long Does it help to improve my motivation	Does meditation really help in controlling thoughts How can I do it on my own
Quora How do you post a question on Quora	What are the best ways to ask a question on Quora
What are the benefits of learning another language	What are the benefits of learning a third language
What are disaccharides What are examples of disaccharides	What are some examples of disaccharides
How can I hack a WhatsApp account	How can I hack another WhatsApp account
What is the best IT field for freshers	What is the best IT field to get in for a fresher
Why doesnt Google buy Quora	Will Google buy Quora
How do we account for transgender people if gender is socially constructed	If society reversed gender roles would transgender people be the same people or different people
How can we improve the education system for high school and college	How can you improve high school education
How do I create a strong password	How does one create a strong password Any tips
Do aliens really exist If so do we have an evidence for it	Do aliens really exists If yes then where
Why do we need to study	Why we need study
What were Hillary Clintons positive achievements as Secretary of State	What is Hillary Clintons greatest achievement as a Secretary of State
How can I get a chance to meet Mr Narendra Modi	How can I meet Modi
What is it like working in Indian Army	What is it like to work in the Indian Army
What is the best way for a native Chinese speaker to learn English	How can I learn English well as a Chinese student
Why do people belive in god	Why do people believe in God What is the real faith in God How do you believe God
How do you compare and contrast the properties of acids and bases	How can you compare and contrast base and acid
What is the best way to do SEO in 2016	How can I do SEO 2016
What defines happiness for you	What defines happiness
What would a male Neanderthal think of a modern woman	I am a female what would a Neanderthal male think of me
What is literally the most fastest way to make money	What are fast ways to make money
How do you edit your Quora profile	How do I edit my profile
What are the ten best short stories written by Isaac Asimov	What is your favourite story by Isaac Asimov
What can one do to relieve severe chronic pain	What has worked for you to help relieve chronic pain
What can I do to improve my English speaking	How can I improve my spoken English
What are some of the best history podcasts	What is the best podcast in history
Do Muslim in India especially in GujaratIndia hatestill Narendra Modi	Why do some Indian Muslims hate Narendra Modi
Have you ever encountered any alien Please be trueDo not make a story	Have you encountered an alien What happened
What are top 5 things I should definitely not do when I am flying	What are the top 5 things I should definitely not do when I am on a flight
How can I recover my Hotmail password	How do I recover my Hotmail password
Is this the real life or is this some fantasy	Queen band Is this the real life or is this just fantasy
How do I learn Python systematically	Starting with no programming experience how long will it take to learn Python 3
How do I know that a guy likes you	How can you tell if a guy likes you or not
I have a 3d printer How can I make money off it	How can I make money with my 3d printer
How much does it cost to develop app like Zomato	What does it cost to develop an app like Zomato Order
Which languages have been profoundly affected by Low German	Which languages have been most profoundly affected by Low German
Whats the reason India fails in Olympics	Why is India failing so miserably at the Rio Olympics
How do I plan a 4 day trip to Goa	How can I plan a 3 days3 nights trip to Goa
What are the minimum GPA and GRE requirements of Florida State University	What are the minimum GPA and  GRE requirements of Florida State University
Why does temperature decrease when altitude increases	Why does temperature decrease with increase in altitude
What are some of the best jokes youve ever heard	What is the most funny joke you have ever heard
How come there are no depictions of the massacres Islam inflicted on India	How come there are no depictions of the massacres inflicted by Islam on India
How Can I impress a girl who hate me	How can impress a girl who hate me
How can I improve my pronunciation in English	How can I improve my English pronunciation
Why did humans come into existence	Why did humans come to existence
What are some common examples of solid matter	What are the most common examples of solid matter
How should I get motivated to hit the gym every day	How can I keep myself motivated to hit the gym everyday
Where can I get fantastic value in Sydney for floor tiles	Where can I get best quality wall and floor tiles at very affordable rates in Sydney area
What are the best ways to learn to code in a short amount of time	How can I learn to code easily and efficiently in a short amount of time
What is the nicest thing that a complete stranger has ever done for you	What is the nicest thing a stranger has done for you
What is the best gift you ever received	Which is the best gift that you have ever received
Who is the best teacher in life	Who are the best teachers of life
If I become a millionaire should I tell families and friends	Should I tell people that I have become a millionaire
What is the name of the creepiest horror movie youve ever seen Which was the scariest part	What is the scariest or creepiest movie you have ever seen
What would be the procedure if a major party nominee died before a general election	What would happen if the presidential nominee died before the November election
What are the biggest regrets of your life	Whats your biggest regret in life
What are the places to visit for a honeymoon in Kerala	What all places can one visit on a two day trip in Kerala India
What are your views on the ban of Rs 500 and Rs 1000 notes by the Indian Government Pros cons	What do you think of abolishing 500 and 1000 Rupee Currency notes by the Indian Government
What is the difference between assessment and evaluation	What is the difference between assessment and evaluation
What are the songs that make you feel happy	What are some songs that just make you happy
What countries are socialist	Are there any socialist countries left
Will Brexit really happen	Is Brexit likely to happen
How can we hack Wifi Passowrds	How do I can hack wifi
How did Portugal become and stay independent of Spain What are the cultural narratives in Portuguese and Spanish histories	How did Portugal become an independent country from Spain
Who will probably win in the war between Pakistan and Iran	Who would win a conventional war between Iran and Pakistan right now
Why does magnetic field produce when current flows in a conductor	Why is a magnetic field produced when current flows through a conductor
Who were the most influential queens in history	Who is the most influential queen in history
How do we allocate memory for a structure and array in C	Are dynamic allocations of array allowed in C
How can I stop overthinking everything in my relationship	How do I stop overthinking situations in my relationship
What are the differences between Chinese and western etiquettes	What are the differences between Chinese and western etiquette
What are some popular method to do suicide	Is there some painless way to suicide
Where can I get wonderful flavors on cupcakes in Gold Coast	Where can I get good quality cupcakes and a lot of different flavor in Gold Coast
Is time travel possible If yes How	Is time travel still theorized as being possible
What is the most spontaneous thing you have ever done	What is the most spontaneous thing youve ever done
Which book to use for preparing chemistry for neet	Which chemistry objective book is good for NEET 2017
How will real estate prices be affected in India after banning of 500 and 1000 rupees notes	How does the demonetized notes of 500 and 1000 effect the real estate
What are my options for earning money online	What are some best ways to earn money online
What was a book that changed you	What is the one book that changed you
What are the things to consider when buying a new laptop	What are the things to be considered while buying a new laptop
How should I stop biting my nails	How can I stop biting my nails for good
How do I avoid looking like a tourist in Paris	How do I dress in Paris to avoid looking like a tourist
What is Ni Introverted Intuition	What is Introverted Intuition
How do I plan a bridal shower party	How can I plan a bridal shower in another state
Why does the Indian education system suck	What is wrong with Indian engineering education system
Why do the Union territories of Puducherry and Delhi have their own assembly	Why do only the union territories of Delhi and Puducherry have chief ministers and not others
What is the story behind the Black Swan movie	What is the story behind the black swan in Swan Lake
Is a third world war coming	Is World War 3 more imminent than expected
What is the best Advantage of using Quora	What is the benefit to Quora
What is so special about Rolls Royce cars that they are only given to respected personalities	Are RollsRoyce cars given only to reputed personalities
Are there any famous people with low IQs	Who are some famous people with low IQs
What are some good places to visit in Kerala on tour	What are some good beaches to visit in Kerala
Can Donald Trump keep his campaign promises	What promises can Donald Trump keep
How come the media doesnt covertalk about Trump alleged raping of a 13 yr old girl trial	Why doesnt the main stream media or Hillary talking about Trumps December trial for raping a 13 yo
How does the HP OfficeJet 4620 Airprint compare to the HP LaserJet Enterprise M506x	How does the HP OfficeJet 4620 Airprint compare to the HP LaserJet Enterprise M606x
What is the best method of losing weight	What are the best way of loose the weight
What has been one of the best decisions of your life	What has been the best decision youve made in your life
What is the most interesting fact that I know but you dont but I shouldnt	What is the most interesting fact that most people dont know about
If God created the world who created God	Who created the GOD
what can i do to become fair	How can I become more white
Why did Arnab Goswami quitted from Times Now	Why did Arnab Goswami resign as the EditorinChief of Times Now
Whats the best why to start up a cafe	What are requirements I would need to start my own cafe
Things to do in Hyderabad	What are the cool adventurous things to do in Hyderabad
Who invented the middle finger bad gesture How was it invented	Who invented the middle finger bad gesture
Are there any Republicans voting for Hillary Clinton	Are there any other republicans here who voted for Hillary Clinton
What physiological tricks are useful to know	What psychology hacks are useful to know
What is purpose of registering with dogs such as a Maltipoo at the AKC	How can you register a Maltipoo at the AKC
What is your most embarrassing moment in public	What has been your most embarrassing moment in front of a stranger
Whats the coolest thing you can do with a computer	What are the coolest things you can do on a computer
How can I prepare for GATE without coaching	How did you prepare for the GATE without any coaching
What should be done to get rid of dandruff	How do I get rid of severe dandruff
Would Donald Trump be the worst president in US history	Is Donald trump going to be the worst president
Is ethics bullshit	Are ethics bullshit
What are the best top 10 movies of Hollywood ever	What are the best movies of Hollywood
What should you do if a cat scratches your eye	What should I do if I have a cat scratch under my eye
What if the whole world had only one religion could we think the world can be at peace then	If the whole world were to follow only one religion would it be more peaceful
How do I get rid of mosquitoes bites quickly	How do I get rid of mosquito bite marks
Did Tywin sleep with Shae out of pure spite	Why does Tywin sleep with Shae in A Storm of Swords
What is it like being the third or nonprimary person in a polyamorous relationship	What is it like to be thirdwheeled in a polyamorous relationship
How likely is it for a black guy to date an Indian girl	Do black guys like to date Indian girls
What is mutual funds with examples	What is mutual fund all about
Which are the best movies of 2016	Which was the best film of 2016
Should I worry about what people think about me	Should I ever care what people think of me
Why is Quora claiming my questions need improvement	Why does Quora keep telling me my question needs improvement
What are the differences between a Btree and a B tree	What are the differences between BTree and BTree
How can you take the battery out of an iPhone 4	How do you take the battery off an iPhone 4
Which is the best laptop under 20k today Fast  smooth	What is the best laptop I could buy under 20k
What are human impacts on biodiversity	What is the human impact on biodiversity
What type of wildlife are native to Turkey	What animals are native to the country Turkey
Can we really hack Facebook	Can I hack Facebook
How do you view the Indian governments decision to fight black money by scrapping 500 rupee and 1000 rupee notes	What are going to be the rammifications of the Indian governments decision affecting invalid 5001000 currency notes
How much time do people spend on Quora	How much time does Quora take up in your day
How is erectile dysfunction treated	How do I overcome erectile dysfunction due to over masturbation
When was the hardest period in your life and how did you get through	What are the hardest time youve seen and how did you get out of it
Will Google purchase Twitter	Will Google acquire Twitter
What should be the strategy to clear IBPS PO	How do prepare the prelims exam of IBPS PO
How does banning 500  1000 rupee notes solve black money problem	Would demonetization of 500 and 1000 rupee notes actually help in curbing black money in India
What happens to a question on Quora if it is marked as needing further improvement	How can I ask Quora a question about something that was marked needs improvement
How can I delete an old Facebook account that I forgot its password	How do I get into my Instagram if I forgot my email and my Facebook password
What is operation quality	What is the operation quality
Is it possible to root an iOS into an Android phone	Is it possible to install iOS to an Android phone
What are some creative and innovative business ideas with less investment in India	What are some best business ideas with minimum investment
Is it legal for traffic police to stand in the middle of the road to stop vehicles	Is it legal for a traffic police to stand at the middle of the road to stop vehicles
Is it stealing if you steal from a thief	Is it stealing if youre stealing from a thief
How can I make a healthy home made pizza	How can I make healthy pizza Is there any recipe for it
What should one read to learn about philosophy	What books can I read to learn more about philosophy
Is Zee news a BJP owned channel	Why is ZEE News so antiAAP
How can I be a native English speaker	How do I speak English like celebrities
How do you write a beautiful introduction to an essay	How do I write the introduction of an essay
Where can I get best assistance in Sydney for any property purchasing	Where can I get knowledgeable assistance for transfer of property in Sydney
How can I improve digestion	How can we improve our digestion
What are some Cyanide and Happiness comics on countries	What are the best Cyanide  Happiness comics
Whats your favourite meal	What is your favourite meal and why
What are some good books for JEE Mains only	What are the best books to practice for JEE mains only
How long will the Pokmon GO fever will last	How long you thing this Pokmon GO trend will last
What are some of the most misheard song lyrics of all time	What are some of your favorite misheard song lyrics
How close are we to World War Three and how bad would it be	How close is a World War III
How can I improve my writing skills and blog style	How can I improve my writing skills for writing a book
What is the concept of sustainable development	What is sustainable development
EMTs and Paramedics How does one treat a gunshot wound	How do you treat gunshot wounds
How did Donald Trump become president	How did Donald Trump win despite projections that he would fail
Where do nuclear reactions occur in the sun Why do they happen	What causes nuclear reactions in the Sun
Whats the first thing you do after you wake up	Whats the one thing you think about when you wake up
What are the main uses of a computer network	What is computer networking
What do Pakistani people think about the Uri attack on 18th September 2016	What do Pakistani residents think of Uri attack
Are animals capable of feelingexperiencing emotions unknown to humans	Do animals have the same emotions as humans
What are the ways in which I can improve my handwriting	How can I have good handwriting
How would Donald Trumps win affect India	How will Donald Trump benefit India
How can changing 500 and 1000 rupee notes end the black money in India	Will banning Rs500 and Rs1000 notes help to solve black money and corruption
Are there any good horror movies in 2016	What are some best horror movies of 2016
How can I overcome suicidal thoughts	How do I overcome suicide thoughts
How can I win in UGC Net Exam in English literature	What are the name of the books for UGC net English literature
Can we eat meat with dairy products	Is eating meat and dairy okay
Why did Sirius have to travel north in GOF	Why did Sirius Black have to travel north in GOF
What is the difference between angel investors and VCs	Whats the difference between a VC and an Angel Investor
What will happen if India and Pakistan gets into war and who will win	If war occurs between India and Pakistan what will be its effect on the rest of country
Can we stop global warming	Do we have any good ways to stop global warming
What is the scope for girls in mechanical engineering	What is the scope of mechanical engineering for girls
Which is better Coke or Pepsi	What is better Coke or Pepsi Why
Why are people addicted to pornography	Why do people become addicted to pornography
Why is dividing by zero an error or undefined	Why is division by zero undefined
What are the best and most effective openings in chess	What are the best opening moves in chess
What if anything is too serious to be joked about	What if anything is too serious to be joked about in life
How much do dental implants cost in India	What is the price for dental implants in Delhi India
Which wood glue would be best for repairing a cricket bat	Which glue is best for repairing a cricket bat
What is the term Padfoot in harry Potter	What does Padfoot mean in Harry Potter
What are some of the most technical questions asked in an interview	What are the questions asked by an interviewer in technical interview
How do I start a plant nursery	How do I get start plant nursery
How much does it cost to develop an Android app in India	How much will it cost to build an Android app in India
How do I stop my YorkieCorgi mix from chewing my shoes	How do I prevent my dog from chewing cushions
How can I build traffic for my website	How can I increase traffic on my blog
How do I prepare for the 10th class ICSE board	How Can I prepare for Class 10th Board Examinations ICSE
How I become a good teacher	How do you become a good teacher
Are Secret Service agents that protect politicians chosen for duty by their political affiliation	Can a Secret Service agents political views interfere with their duty
Does critical thinking help to burn calories	Does thinking burns calories
What are some ways to delete my Yahoo Mail account	What are some ways to delete my Yahoo Mail account permanently
How much bigger can a male bicep muscles get than a females	How much bigger can a males bicep muscles get than a females
Does meditation increase creativity	Can meditation increase creativity
What is the thought process behind designing a countrys national flag	How is the story behind your countrys national flag
How will work and jobs change over the next 1020 years	How will work and jobs change in the next 1020 years
How does one fall in love	How is it to fall in love
Does global warming exist	Is the global warming climate change things for real or a hoax
What is your favorite saying and why	What are some of your favorite sayings
Why does the caste system persist in India	Why caste system still survive in India
What is the best way to send a fax from Australia to the United States	How can I send a fax from Australia to the United States
Is it true that the new Rs 2000 currency notes in India will have a nano GPS chip	How much is the truth that the new high denomination currency of India are being embedded with GPS nano chips
What is the best app for Berlin public transportation	What are the best public transportation apps to help me in Berlin
Who is your role model and why	Who is your role model and why
How much money per month is enough to live as a graduate student in Birmingham UK	How much money is enough for a student to live in Birmingham UK
How did you teach your kid not to lie	What are good ways to teach children not to lie
How does Minerva Schools differ from other forprofit universities in the US	Why will Minerva succeed when many other forprofit universities have been bad investments
How do I get clients for my software startup company	What are the best ways to get clients for software startup
How do I delete my questions off Quora	How do I delete a question from Quora
What was the reason of extinction of the Indus Valley and Harappan civilization	Who were responsible for the collapse of Indus Valley Civilization
Is a circle a regular polygon of infinite sides If yes then discuss its properties and its interior angles	Can one say that a circle has infinite sides
When did humans start naming themselves Whats the history behind names Do nonhuman species use names	When in history did we start giving people names
Why are there so many Muslims in our Bollywood industry	Why are there so many Muslims in Hindi film industry
What should you do if you cant remember your iCloud password	How do I recover my iCloud password
Is Quora display trending now topics based on users country	Are trending topics in Quora location specific
As an international student from India going to Florence Italy what are the essentials I must carry	As an international student from India going to Florence in Italy what are the essentials I must carry with me
Can you get high eating a few specks of weed accidentally	Whats the best way to get high from eating weed and why
Which are the oldest bridges in the world	Whats the oldest bridge in the world How was it designed and built
How can I get a green card to live and work in the USA	How can I get a green card
What should we do to be best software developer	What is to be done to be a good software developer
How can I find a startup mentor	How do I ask someone to be my mentor
Is it possible to invent the time machine	Can we create a time machine
How good and reliable are OYO rooms	Did anyone experienced OYO rooms Is it a good experience with OYO rooms
What websites do you use everyday	What websites are worth visiting everyday
What are some little things that make you happy	Whats the best thing that make you happy
What are the best earphones underaround Rs2000 	Which are the best earphones under 2000INR or 35USD
What made Tata group chairman Cyrus Mistry to quit	What was the reason behind the removal of Cyrus P Mistry from the position of Chairman of The Tata group
Which is the best place to visit in Goa with Friends	We are Planning to visit Goa for three dayswhich are the best places to visit
How can plastic wrap be used for weight loss	Are athome stomach wraps using the clear plastics wrap in your kitchen safe to use for weight loss
Where can I get wonderful flavors on cupcakes in Gold Coast	Where can I get an unique taste for cupcakes in Gold Coast
What are some indie bands worth listening to	I am interested in listening to indie music Which bands can convince me to give it a try
What gives you hope during tough times	What gives you hope for humanity
Whats the procedure for an Indian student to get admitted into a MS program in the US	Whats the procedure for an Indian to do higher study MS in the US
Can skipping increase your height	What is the best and fastest way to increase your height
What is light made up of	What exactly is light made of
How do I deal with common embarrassment	How do I deal with my embarrassment
What can I do right now to help the people of Aleppo	What can I do to help the situation in Aleppo
How much does investment banker earns	How much do investment bankers make
What are your views on ban of 500 and 1000 rupee notes in India	What will be the result of banning 500 and 1000 rupees note in India
How can I get text records from metro pcs account	How can I get my old call history and text messages from metro pcs
How can I travel with low budget	How do I travel with a low budget
What doe Quora mean	What does the name Quora exactly mean
How do I stop feeling insecure	How do I stop feeling insecure about myself
How often do you drink coffee based drinks	How often do you drink coffee
How do I delete my question from Quora	How do I delete my own question from Quora
Wine What are the best wineries to visit in the Healdsburg area	What are the best Healdsburg wineries
Which is the best honeymoon destination in kerala	Which are the best honeymoon locations in Kerala for summer honeymoon trip to Kerala
How do i lose weight	How do I suck it up and lose weight
Why do people write long answers on Quora	Why do people on Quora write very long answers even if the questions doesnt necessarily need that
What is the relation between Snoop Dogg and Wiz Khalifa	How is Snoop Dogg related to Wiz Khalifa
How can I see who viewed my Instagram video	How can I see who viewed my video I just posted on Instagram
Should I use Swift or ObjectiveC to learn iOS development	Which is better to learn for iOS Swift or ObjectiveC
Is EEE in VSSUT Burla good Is the placement good What type of companies recruit EEE graduates	How is EEE in VSSUT Burla
What is difference between Modi and Hitler	How Modi is different from Hitler
How can Jio work in a 3G phone	How do I use Jio sim in 3G devices
What is the best way to restore a Dell Inspiron 530 to factory settings	How do you restore a Dell Inspiron 1525 to the factory settings
How did the Australian term sheila originate	What does the Australian term sheila mean
How can India be a secular century when there is no Uniform Civil Code in place	Why is the implementation of Uniform Civil Code important
What are the side effects of ProActiv	What are the side effects for using Proactiv How are the side effects treated
what has your life taught you so far	What has life taught you
How can I run a 5k without any training	How do I run a 5k without much training
What are the pros and cons of tennis balls on your walker	What are the pros and cons of attaching tennis balls on walkers
Why are the Texas Rangers important to law enforcement today	What are the responsibilities of Texas Rangers and how do they interact with other law enforcement agencies
What is humanity What is human rights	What do we mean by human rights
What is the difference between amateur ham radio and CB radio	How do HAM Radio and a CB Radio differ
What were the reasons for Industrial Revolution	What were the causes of the Industrial Revolution
How can I view a private Instagram	Can I view a private Instagram
Why World War III are inevitable	Is World War III coming
What is the Syria civil war all about	What is the Syria civil war
What is a psychology	What is psychology
Can you suggest a best budget phone below 15k	Which phone is best under 15k
What are the 6 mother sauces What are some recipes using them	How are the 6 mother sauces used in cooking
What is the best way to prepare for the theoretical part of the CA Final Exam	What is the best way to prepare for CA final group1 papers
Where  can i sell a business idea	Venture and Investor Pitches How do I sell my product idea
What are the ways to learn about stock market	What is the best way to learn about investing in the stock market and what stocks to buy
Quora How to ask question on Quora so that it wont get marked as needing improvement	I cant seem to ask anything anymore Why does Quora keep marking all my questions as needing improvement
What is funniest joke youve ever heard	What is the best joke ever heard
Is there any proof which can be given for the existence of the GOD If yes what are those	Is there any proof that there is no god
What is the best and quick way to lose weight	What is the best way to loose weight quickly
What is the difference between transgender man and transgender woman	What is the difference between a transgender man and a transgender woman
What job can a foreigner have in South Korea	How can a foreigner get a job in South Korea
Is creating satelite blogs and posting SEOfriendly posts considered blackhat SEO technique	Is creating satellite blogs and posting SEOfriendly posts considered blackhat SEO technique
Why dont some peoples answers have a place to comment	Why some answers dont have comment option
What are the best Smartphones tech gadgets	What are the best available technology gadgets
How can I speed up my Internet connectionn	How can I speed up my Internet connection
How can you find what your cell phone number is	How do I find my cell phone number
How will the ban on Rs 500 and 1000 notes impact the Indian economy	How does the ban on 5001000 denominations affect various domains of the Indian economy
How do we live a meaningful life	How do I lead a meaningful life
How can you enlarge your penis	How can I have a big penis
How do you delete a question you asked on Quora	Is it possible to permanently delete a Quora question
What are the pros and cons of client server networks	What are the pros and cons of client server network
What is the best way to learn to play the guitar by myself	How can I learn to play the guitar by myself
How can I unlock iphones	How do you carrier unlock an iPhone
What is the best programming language one must learn to stay updated today	What is the best programming language to learnin your opinion
Why would Ryan Lochte lie about getting robbed at Rio 2016	Why would Ryan Lochte lie about getting robbed by cops
How do you become a military pilot	How can I become a military pilot
What are the best novels ever	What are best novels to read
What is the national language of India	What is Indias national language
England v Wales  who will win	Who will win the England v Wales match
How do I concentrate better in my studies	How can I can concentrate well in studies
What do you think you were in a past life and why	Who do you think you were in a past life
How do I prepare for the GATE and is coaching necessary or not	Is it necessary to go for coaching for GATE preparation
Why do we fall for someone whom we cant be with	Why do we fall for someone whom we cant be a part of their love
What are the emerging trends in structured programming	What are the emerging trends in structural programming
What should I do to improve my English 	What is the best way to improve my spoken English soon
Which Instagram hashtag is best to attract more followers	What are the best hashtags for Instagram likes
How did Donald trump win	How did Donald Trump win despite projections that he would fail
Have you ever had sex with your teacher	Have you ever had sex with a teacher
What is Dynamo	What is a dynamo
How much does a uber driver earn in India	How much does Uber driver earn in India
How can I find a job in Mumbai	How do I find a job in Mumbai
How is daily life in North Korea	How is life in North Korea What are the typical lifestyles of different sections of people in North Korea
Why or why not should the minimum wage be raised to 15	Should the minimum wage be raised to 15hr for all American workers
What are some of the best tourist places to visit in Chhattisgarh	Where are the foremost tourist places in Chhattisgarh
Which sites are best for learning algorithms and data structures over video	What is the best site to to learn data structures and algorithms from video tutorials
Why do people go for mba after masters in engineering	Why do people do MBA after engineering
How does a facebook account get hacked	How can I hack somebodys Facebook account if that person is not added as a friend
Why do black people get upset when nonblack rappers use the Nword	Why is it considered offensive when nonblack people use the n word but not when black people do
What are the major differences between Chinese culture and Western cultures	What the difference between western culture and Chinese culture
What does Java do and do I need it	Do I need Java on my computer
The weak and ignorance is not an impediment to survival arrogance is	The weak and ignorance is not an impediment to survival arrogance is in Japanese
Is it right time to associate the car with Uber Pune	Is it the right time to associate car with uber in pune
How is replacing 1000 rs notes with 2000 rs notes going to make black money hoarding a lot harder	How would demonetizing 500 and 1000 rupee notes and introducing new 2000 rupee notes help curb black money and corruption
What is paradox	What is a paradox
Is coaching necessary to crack JEE Advanced	Is it necessary to take a coaching class to prepare for the JEE Advanced
How do I clear a clogged ear	How do I unpop a clogged ear
How can I earn from online	What are the best ways to earn money from home
Is our PM Modi doing the correct thing with 500 and 1000 Rs notes	Why Narendra Modi banned 500 and 1000 notes in India
If you were given a chance to be somebody else for a day who would you be	If you were given a chance to be somebody else for one day who would you be
Has there been scientific evidence that ghosts exist	Has there been any serious scientific study into unexplained phenomenon such as ghosts etc
Would you want to know how youll die or when youll die	Would you rather know when you will die or how you will die
What can I do to practice my English	How can I continue to improve my English
Is there an option for personal chat on Quora	Is there no option to chat with a person on Quora
Can people actively control their emotions	How do I gain emotional intelligence and control my emotions
What would have happened if Krishna is not on the side of Pandavas	What would have happened if Krishna was not on the side of Pandavas
How should I prepare right from first year to crack Google Summer Of Code	What are the tips for clearing Google Summer of Code
Where I can find cheap but branded cloths in Bangalore	Where can I find good branded clothing in Bangalore at cheap price
How is culture important in life	What is the importance of culture in our life
How can you increase your tolerance for pain	How do you increase your pain tolerance
How funny was the TV Show Joey after FRIENDS	Have you watched Joey TV Show after watching FRIENDS
How do I improve at drawing	How do you improve your drawing
Why is Saltwater taffy candy imported in Japan	Why are saltwater taffy imported in Japan
What is jayalalithas health issue	How is chief minister Jayalalithas health condition
Should porn websites will be banned from India	Should porn websites be banned in India
Fitness What can I do to reduce my bulky tummy	How do I reduce tummy
Why do some people sweat excessively in their armpits	Why some people sweat excessively in their armpit but it has no odorous stinky smell
How can can I delete my yahoo email account	How can you delete your Yahoo Mail ID
What is your review of the 2016 MacBook Pro	What is your review of the MacBook Pro 2016
Is there any proof that ghosts really exist	Do ghosts really exist If no how do we explain some people getting possesed
How do I recover from moderate depression	How can I recover from depression
How do I make money from my Car	How can I make money from my car
What is the salary of an engineer	What is the salary for engineer
How can I overcome negative thoughts	How can I Ignore negative thoughts
How do I stop being socially awkward and introverted	How do I make friends as a shy socially awkward introvert
What are some lesser known facts about ants	What are some interesting facts about ants
How can I create a type writing effect on a template	How can I create a typing effect on my website
How do I become a career counselor	What one has to do for becoming career counselor
How can I stop myself from being extrovert	How should I stop being an introvert
Are near death experiences real	Are Near Death Experiences Proved
Is it possible for a mobile phone to explode	Do mobile phones explode
Do blackholes exist	Do black holes exist
What are the most beautiful French songs	What are some good French songs
What would be the best flight simulator for a laptop	What would be the overall best flight simulator for a laptop
How did Donald Trump win despite projections that he would fail	How did Donald Trump win the Presidential election
Why cant I follow a question on Quora anonymously	Why cant you anonymously follow a question on Quora
What do you struggle with most in your life	What are you struggling with in your life
Why cant anything travel faster than the speed of light	How do we know that nothing can travel faster than the speed of light
Which moment in your life changed you completely	What was the moment in your life that changed it completely
How will the ban of Rs 500 and Rs 1000 notes affect Indian economy	What are your views on India banning 500 and 1000 notes In what way it will affect Indian economy
Why did Hillary Clinton think it was necessary to use a private server to conduct her personal and government communications	What is the real reason that Hillary set up her own private email server as Secretary of State
Do I need to watch Harry Potter before watching Fantastic Beasts and Where to Find Them	Should I watch the Harry Potter series before watching Fantastic Beast and Where to Find Them
Why does some engineering students struggle to get job	Why do engineering graduates not get jobs
What are the biggest strengths of The Indian Army	What are the best strengths of Indian Army
Do you think chatbots are really the new apps	Are chatbots the new apps
How should I start learning Python	How should I begin learning Python
Does financial modelling have any scope in India	What is the Scope of financial modelling in India
How is Narendra Modi as a person	What is like to meet Narendra Modi
In how many ways can we create object in Java	How many ways can we create an object in java
Where can I sell my unimplemented business idea	Where  can i sell a business idea
Can I use Jio 4G sim in 3G mobile	Jio 4G on 3G mobile
What is that one question or answer on Quora that changed your life	What is that one question or answer in Quora that changed your life
Why do some people still think Global warming a myth	Why are there people who still dont believe that global warming is real
What is the best romance anime	What is your absolute favourite romance anime
What are some books to expand your mind and increase intelligence	What are some books that expand our mind
What matters at the end most	What matters at the end of the day week month year and Life
How do you earn money from internet	How can we earn money online in india
What makes Earth to rotate on its axis	What Is the cause of earth rotation around Its axis
How do we should live	How do we live
Whos your favourite character in the Walking Dead	Who is your favourite character in the TV series The Walking Dead Why
Should you tip your Lyft driver	Should you tip your Uber driver
What is your political affiliation and why	What are some political affiliations
What do you think about banning 500 and 1000 rupee notes in India	Was the decision by the Indian Government to demonetize 500 and 1000 notes right or is it a big scam
What programming language I should learn first	What is the best computer programming language to learn first
How can I start my startup	Whats the best way to start a startup
What are the best restaurants in Silicon Valley overall	What are some good restaurants in Silicon Valley
What are the best workout songs	Which are the best workout songs
Who is next CM of Gujarat	Who will be next CM of Gujarat
What is the taste of semen	What does cum taste like
Is there any way to recover an email in Gmail after its deleted from the trash	Is there anyway to retrieve my deleted emails from my Gmail account
Why do people on Quora ask silly questions about the facts which can be googled very easily	Why do some people ask questions on Quora that could be asked directly to a search engine 
Why do people ask such stupid questions on Quora	Why do people have to ask Quora for questions
How was it to meet Richard Feynman	What was it like to meet Richard Feynman
What should I do to make money online in India	What are some easy ways to make done extra money online
What are your views on responses given by Presidential candidates on the first debate 2016	What do you think about the first presidential debate between Hillary and Trump
What is the best workflow process from web design to web development using Adobe muse	What is the best workflow process from design to development using Adobe Muse
How can I gain weight as an 18 year old girl	How do I gain weight as a teenager
How I can be good at handwriting	How can I have good handwriting
How do kilns work	How does a kiln work
What is the current political scenario of India	What is the current political scenario in India
How can I create multiple streams of income	Can a person realistically create multiple streams of income
How did you learn to speak English	How can I learn to speak a fluent English
Why did people think that Donald Trump will be a good president and voted for him	Why is Donald Trump so popular
What causes a premature birth	What are the causes of preterm birth
I am poor in English grammar so how should I improve my grammar	What can I do to improve my English Grammar
What is the best App for downloading films for free	What are the best apps for downloading films for free
Why are some questions marked as needing improvement when clearly they do not need improving	Why do all of my questions on Quora need improvement
How can I fall in love	How is it to fall in love
Which laptop is best to buy within the range of 30000rs	which laptop will be best under Rs 30000
Is it possible to crack the JEE Mains and Advanced 2016 if I start preparing now	Is it too late to start preparing for the JEE Mains 2016 if I start right now
Why do people believe in God and how can they say heshe exists	Why do people believe in a higher power and God
How do I become the Top Writer on Quora get more upvotes and better stats	How do you become a Top Writer on Quora for 2014
How do I make India as corruption free	What steps must Indians take to make India corruption free
What is the best food in Pune and where do I get it	What is the best food in Pune
What would be a realistic plan to lose weight	How can I efficiently lose weight
How do I tell the difference between all NASAs space shuttles	Were there any substantive differences between the space shuttles
What can I do after completing Bcom	What should I do after completing my bcom
How do you move on with a broken heart	How do you get over a broken heart
Why has not any Indian Mathematician won a Fields Medal	Why has an Indian born person never received the Fields medal
Which is the best Teradata online training	Where is the best institute for Teradata Online Training
How long will the reservation system quota continue in India	Will the castebased reservation system come to an end in India
How do I make money starting a blog	How can I start making money by starting a blog
What are the east way to hack whatsapp	Can someone hack my smart phone using WhatsApp
What are scotch eggs and when were they invented	What are scotch eggs and what are their origins
What are the best games for couples to play	What are some good games for a couple to play
How do I convert NRE FD to RFC	How do I convert NRE FD for RFC
What might cause a brown discharge during the menstrual cycle beforeduringafter menstruation	Why do I get a brown discharge before my menstrual cycle
How do I ask questions with pictures on Quora	How can ask questions using photos
What skills do all successful salespeople have in common	What personality traits do all successful salespeople have in common
How do you get a job at an embassy or consulate	How can you get a job in any embassy
What are arguments in favor of Israeli settlements	What defense is there of Israeli settlements
How do you become a freelance writer in India	How can I become a freelance writer in India
How can I draw myself as an anime character	How do I draw my anime character
How does a capacitor regulate	How do capacitors regulate
How come on some answers on Quora it says cannot add comment at this time	Why is there no comment section on some answers 
What can one do to control hisher anger	Whats the best method to control anger
What are the best digital marketing courses for midsenior level marketing managers	What is the best digital marketing course available online and offline in India and Why
What is normalized score in gate exam	What is normalized score in GATE
How do I impress my Wouldbe Motherinlaw	How do I impress my mother in law
Whats the worst experience youve had while in a restaurant	What is the worst restaurant experience you ever had
Which are the better laptops HP or Dell	Whose laptops are better HP or Dell
What is that one decision that changed your life forever	What is one decision that changed your life forever
Why are the oil prices decreasing	Why crude oil price is decreasing
How do you get over an attitude problem	How do you solve an attitude problem
Shouldnt we have debates between NaMo and RaGa similar to the US presidential debates	Why there is presidential debates in US and not in India
Human Behavior What is the one lie that you tell yourself repeatedly	What is the lie you tell most often
I want to buy a 32 inches LED TV under Rs 20000 Is online LED TV is safe	Which is best 32 inch led tv to buy below 20000 INR
What is a goood answer to Why should I not hire you	What is the best answer to why should I not hire you
In which order should one watch all the marvel movies and TV shows in order to understand the timeline well	What would be a good chronological order to watch all the Marvel MCU movies in
What evidence is there for Jesus Christs death burial and resurrection	Is there extra biblical evidence for the resurrected Jesus Christ
How long does it take to be a professional web designer	How long does it take to become a decent web designer
What is the best way to commit suicide	What is the easiest way to commite suicide
Is mechanical keyboard really helpful for touch typing	Is mechanical keyboard helpful for Touch Typing
What are the best programming languages to learn today	How many languages need for computer programming and which is the best
Is the global warming climate change things for real or a hoax	Is it possible that global warming is a hoax
Who was the greater general Russias Zhukov or Germanys Von Manstein Why	Who was the greater General Marshal Zhukov of Russia or Van Manstein of Germany Why
Does having bad teeth kill someone faster	Does having bad teeth mean you will die young
How did Donald trump win the elections	How can Donald Trump win the elections when people hate him so much
How can medical doctors move into biotech or molecular biology	How can medical doctors move into biotech
Does masturbation affect bodybuilding or muscle growth	Does masturbation affects bodybuilding or muscles growth
What is the best advice your father ever gave you	Whats the best advice your father ever gave you
Which is the best Test Series SSC CGL Tier 2 exam	Where can I find mock test papers for SSC CGL tier 2
What is the difference between a public sector unit job and a government job	What is the difference between Public Sector Undertaking PSU jobs and government jobs in India
What is the health condition of Jayalalitha	What is the true health status of TamilNadu CM J Jayalalitha
How does Cantonese Chinese differ from Mandarin	Whats the difference between Cantonese and Mandarin
What are the best iphone gadgets that you should buy	What are the best iPhone gadgets that really worth buying
Can WhatsApp be hacked	Is WhatsApp hacking possible
Is ice lighter than water	Why is ice lighter than water
Why do I never have nightmares	Why dont I get nightmares
What are some online resources to learn UI design	What are good resources for learning Software UI design
What are some good psychological hacks	What is the coolest psychological trick
How do you deal with emotionally abusive parents	Psychology of Everyday Life How do I deal with emotionally abusive parents
What is the basic purpose of nuclear bomb	For what purpose are the nuclear bombs
What are tips and hacks at finding cheap flights	What are some hacks on booking cheap flight tickets
How do I choose the best taxi services in Udaipur	How do I choose best taxi service in Udaipur How can I find that
Is Donald Trump really a racist	Do you think Donald Trump is a racist If so why
How can I find work experience in Investment banking in London	How do I find investment banking work experience in London
What is a weak entity in DBMS Why is it called weak	How do strong entity and weak entity sets differ in DBMS
Do irregular periods after marriage delay conceiving	Do irregular menstrual periods affect female fertility
What are the best institutes to study a big data course in Hyderabad	What are the best institutes for big data in Hyderabad
How many times will you have sex in a day	How many times should one have sex a day
What causes people to judge a person by the way they look	Why do we often judge people by their appearance
How much equity should I get as CTO	How much equity should I get as CTOcofounder
How does one ejaculate without achieving orgasm	Can one ejaculate without orgasm
What is the need of a president in a country like India	Is a president needed in a country like India
Why are Indians obsessed with God and religion	Are Indians so obsessed with the notion of religion and caste
How can I improve my c programming skills	How can I improve my C programming
What is are the best jobs in the Philippines	What is the best work in the Philippines
What is the one thing that you would like to do if you had an unlimited amount of money	If you had an unlimited amount of money what would you do with your life
What is the best european country to start a business	Whats the best European country to start a business in as a US citizen
Why do some answers collapse in Quora	Why are so many good quality answers collapsed on Quora
Which is the best nonfiction book you have ever read	What are some good nonfiction books that I should read
What is the best SIP Plan in India	Which Best SIP plan in india for investement purpose
How do purified and distilled water differ	How are distilled water and purified water the same
Do I need any previous knowledge of Star Wars franchise to seeappreciate Rogue One A Star Wars Story	Do I have to have seen any other Star Wars movies to understand Rogue One A Star Wars Story
What was the best advice youve ever received	What is the best advice you ever received
Could Bruce Lee stand MMA fighters	Would Bruce Lee at his peak be able to contend with todays top MMA fighters
Was the White House built by slaves	Was the White House entirely built by slaves
What are the best Pokemon hacks	What are some of the best Pokemon Go hacks
What is a Real Programmer	What is the definition of real programmer
Is there going to be war against Russia	What is the likelihood of war with Russia
What should be Indias move against Pakistan after Nagrota attack	What steps should be taken immediately by our country against Pakistan for 29 th November attack
What would happen if both Trump and Pence were assassinated before taking office	What would happen if both Donald Trump and Mike Pence were assassinated before the election
Is the lowest sum rule still used in naming of organic compounds	Is the lowest sum rule still used in naming organic compounds
What are the best arguments for the war on drugs	What are the strongest arguments for and against the war on drugs
How many all time views do you have on your Quora answers not questions stats	How many all time views do you have on your Quora questions not answers stats
What are the prominent features of usability that your organization considers while purchasing the ERP system	What are the prominent features of usability that your organisation considers while purchasing the ERP system
what are the signs a guy likes you 	How do I tell if a guy likes me
How do I deal with a dominating friend	How should I deal with dominating friends
How can I delete Facebook messages or Conversation	How do I delete Facebook messages that I send to others
How important our education	How important is education
What are the best universities in Germany for a Masters in computer science	What are some good universities in Germany for masters in computer science
What kind of programming language should I learn if I want to debug a gamemaking website like Zondlecom	What programming language should I learn if I want to create games
What is the one shot stop percentage with a Desert eagle 50AE	Is 3  the survival chance of a direct hit to the head from a Desert Eagle 50AE
Do parents really love all their kids equally	Do parents really mean it when they say they love all their children equally
How can I unblock my Facebook account on Chrome	How can I unblock a Facebook account on Chrome
Where why and how did feudalism start	How and where did feudalism develop
How do I stop my addiction to porn and masturbation	How do I stop addiction to porn
How do you balance the deamnds of being a parent with running a business	How do you balance the demands of being a parent with running a business
What is the QuickBooks payroll tech support number in Washington	Which is the best QuickBooks proadvisor tech support number
Is there proof of extra terrestrial life	Do we have proof for extra terrestial life
What are my options after mechanical engineering	What is the best option after btech in mechanical engineering
What is going on between Hrithik roshan  Kangana Ranawat	What is going on between Kangana Ranaut and Hrithik Roshan these few days
What are the benefits of Joint Family	What are the benefits of a joint family
Which is the best Mutual Fund in India	What are mutual funds and which is the best one in India in which to invest
What are some ways you can get into Johns Hopkins University	How do I get the offer from university such as Johns Hopkins
Whats the best way to copy music from my iPhone back to iTunes	How do I backup my pictures and music from my iPhone to iTunes
What is UPI  Unified Payment Interface	Can someone enlighten me on national payment corporation of Indias initiative on Unified Payment Interface
What phone do you use right now	Which phone do you use and why
Where can I find best quality DJ for festival in Sydney	Where can I get best festival DJ services in Sydney
Which is the best SEO Company in Delhi	Which are the best seo companies in DelhiNcr India
How can I enjoy my life the most	How do I enjoy the life
What is your best sexual experience	What was your most favorite sexual experience
Why do people think that they are better than everyone and everything else	Why is it that people think that they are better than everyone else
What isare your New Year resolutions for 2017	What are some new year resolutions for 2017
Is India Developing the right way	Is India developing in the right direction
Is the government hiding or harboring aliens	Why wont the government announce aliens Would there be some kind of distress on earth
What can an introvert do to become an extrovert  viceversa	How do I stop being an introvert and become an extrovert
What can we do to fix Americas inner cities	How could America improve inner cities
How attractive would you rate your physical traits on a scale of 1 to 10	How much will you rate your physical appearance in the scale of 1 to 10
What is the extent of the US Navys presence inside the Great Lakes	Does the US Navy have a permanent presence on the Great Lakes
Why are Indians so obsessed about what people from other countries think about India	Why are Indians so obsessed in knowing thoughts of other countries about them
What happens when you die in a dream	What happens if you die in a dream
What products should I use to get rid of acne quickly	How can I get rid of acne and its effect
Is there any formula for finding nth prime number	What are good ways to find nth prime number in the fastest way
Is Electricity an invention or a discovery	Is electricity considered an invention or a discovery and why
Are Hillary Clinton supporters worried that shes a war hawk	Is Hillary Clinton ProWar
How old is too old for med school Or law school	Is 25 too old for med school
How can I crack JEE	How can I crack JEE exam
Why cant we have one child policy in India	How many agree that families should be allowed to have only one child in India
How should a teacher maintain discipline in the classroom	How can a teacher maintain discipline
What are the differences between human beings and animals	What is the difference between humans and the other animals
How do I turn someone down nicely	How do you turn someone down
Is iPhone 5s compatible for Jio VoLTE app	Is I phone 5s 4G volte supported
Why is Salman Khan so overrated	Why is Salman Khan so overrated in India
What are some mindblowing iPhoneAndroid gadgets that most people dont know about	What are the most useful devices or gadgets you own for your smartphone that maybe other people dont know about
What are the major differences between Chinese and Western culture	What is the difference between Chinese culture and Western culture
How do I know if I am Republican or a Democrat	How do I know if I am a Democrat or Republican
Do you believe in witchcraft	Do you believe in the powers of witchcraft
I suspect my spouse is cheating how do I know for sure	How can I know if my spouse is cheating
How can I remove screen overlay on my j7 2016	How do I turn off the screen overlay in Samsung j7
When you write a rhetorical question do you follow it with a question mark or a period	Punctuation Is it correct to add a question mark after a rhetorical question
Can skipping increase your height	How do I increase the height
What is our purpose in being here	What is the purpose of existance
Why does Quora limit my question details to 300 characters	Why is there a sign limit on Quora for questions
Are public sector jobs and government jobs the same If not the same then what is the difference between them	What is the difference between Public Sector Undertaking PSU jobs and government jobs in India
How can I get out of my comfort zone and be myself at the same time	How do I break out of my comfort zone
What is the Syllabus of UPSC exams	What is the syllabus for UPSC Exam
How do you control your anger	How do I control my emotions and anger
Why is Cricket not popular in US even though it was a British colony	Why is cricket not popular in the US despite being a part of former British colonies
Does Lipton green tea Assist in weight loss	How Green tea is useful for reducing fat
Can anyone increase their height at the age of 21 or 21	How girls can increase their height after 18 years
How do I travel for cheap	What are some tips for travelling cheap
What is the best weekend escapade from Pune	Which is the best place to hangout with friends in pune
What really happened at MG Road Bangalore on New Years Eve 2017	What exactly happened on 2017 New Years Eve in Bengaluru What could be causes of this
What do you like about China	What do you love about China
Whats the best plan to lose weight	What are the best things to do when working on losing weight
Whats it like to be married to a pornstar	What is it like to be married to a pornstar
How does a person get over the fear of commitment	What is the fear of commitment and how to you get over it
Which laptop is best under 50K now a days	What are the best laptops under Rs 50000
How much does its cost to build an iPhone	How much would it cost to build your own iPhone
How do I clear IBPS PO in one month	How do I prepare IBPS PO exam in one month
How do people randomly find me on instagram	How do people find me on instagram
What is the main purpose of jailbreaking	What is the main purpose of jailbreaking an iPhone How is it done
Will Muslim population overcome Hindu population in India in future	Can India become a Muslim majority state in near future
What are the safety precautions on handling shotguns proposed by the NRA in Minnesota	What are the safety precautions on handling shotguns proposed by the NRA in Rhode Island
What is the poorest country in the world	Who is the richest country in the world
What is better Microsoft or Apple	Which is better Microsoft or Apple
What can I do to practice my English	How can I learn to speak a fluent English
How can I promote Udemy course	What are the best ways to promote Udemy courses
What is the effect of demonetization of 500 and 1000 rupees note	What do you think about decision by the Indian Government to demonetise 500 and 1000 rupees note
Is coaching necessary for cracking the GATE	Is it necessary to go for coaching for GATE preparation
What are the differences between CSE and ITISE	What is the difference between CSE and IT engg
If a war breaks out between India and Pakistan who would win	Who will win if a war starts between India and Pakistan
What is the reason behind having one small testicle and bone bigger comparatively	What is the reason behind having one small testicle and other is bigger comparatively
What are the daily life examples of shear stress	What is shear stress Also give any real life example of it
Should I drop a year after engineering for GATE preparation or join Infosys as a fresher	Should I drop 1 year after a BE for CAT preparation
What can India do in Syria	What can India do to support the people suffering from civilian war in Syria
Does penis size really matter and What is the size of your penis	Does penis size matter for girl or stamina
How much black money is recovered till now	How much black money will the government get back after demonetization
How can I speak English more fluently	How do I speak English like celebrities
What is your favorite ice cream brand and flavor	Which is your favorite ice cream brand Which flavor and why
How do I get rid of my acne and get nice skin	How can I get rid from my acnes
What is the easiest way to enrich vocabulary	What is the easiest way to improve my vocabulary
If the universe is expanding then what does it expand into	If the universe is expanding what is it expanding into And how will this effect us
What would happen if the internet shut down and how could it happen	What would happen if the internet shut down today
I do masturbation twice in a day Does masturbation affects mens sperm count or does it cause infertility	Does masturbation cause infertility
What is the best way to learn astronomy	How can I learn astronomy
I wanna start preparing for ias exam how should I proceed	How should I start preparing for UPSCIAS exams
Where can I get an exceptionally affordable price in Sydney for property transaction	Where can I get quality assistance in Sydney for any property transaction
Do you believe that people can change	Do youwould you like to believe that people can change
What are the advantages and disadvantages of studying abroad And which one is better	What are advantages and disadvantages of studying abroad
What do Trump supporters think of his Cabinet picks	What do Trump supporters think about his recent cabinet appointments
